||     |||
|  ||    E
|  ||    |
S  ||    |
||||||||||
